GeneName	System
AANAT	Melatonin
ADRA1A	Norepinephrine
ADRA1B	Norepinephrine
ARNTL	Circadian
ASCL1	Serotonin_Progenitor
ASMT	Melatonin
CLOCK	Circadian
CRY1	Circadian
CRY2	Circadian
CSNK1E	Circadian
DDC	Placental
DRD1	Dopamine
FEV	Serotonin
FOXA2	Serotonin_Progenitor
GABBR1	GABA
GABRA1	GABA
GATA2	Serotonin_Progenitor
GATA3	Serotonin
HTR1A	Serotonin
HTR1B	Serotonin
HTR1D	Placental
HTR2A	Serotonin
HTR2C	Serotonin
HTR7	Serotonin
INSM1	Serotonin_Progenitor
KCNK2	Serotonin
KCNK3	Serotonin
KCNN3	Serotonin
LMX1B	Serotonin
MAOA	Serotonin
MTNR1A	Melatonin
MTNR1B	Melatonin
NKX2-2	Serotonin_Progenitor
NR1D1	Circadian
NR3C1	Glucocorticoid
NTN1	Placental
OPN3	Light_Sensitivity
OPN4	Light_Sensitivity
OPN5	Light_Sensitivity
PER1	Circadian
PER2	Circadian
PER3	Circadian
RHO	Light_Sensitivity
RORA	Circadian
SLC6A2	Norepinephrine
SLC6A4	Serotonin
TH	Dopamine
TPH1	Placental
TPH2	Serotonin
